H H w w H H H H H H H H H H H H
H t T T t H t , E - - m , v E H
H s C c , + , , , , , S o j E H
H s , t s H , , E - - m , v E H
H H + H H H H H H H H H H H H H
H , , , , t , , , , H t s , b H
H , , , , , , , , , + , , , T w
H t p , p t , , t , H t s , t H
H H H + H H w w H H H H H H H H
