H H w w H H H H w H H H H H H H
H t T T t H t , , t H t s , b H
H s C c s H s , , , + , , , T w
H s , t s H s , , , H t s , t H
H H + H H H s , , t H H H H H H
H , , , , t , , , , H t s S b H
H , , , , , , , , , + , , , T w
H t p , p t , , t , H t s , t H
H H H + H H w w H H H H H H H H
