H H w w H H H H H H H H H H H H
H t T T t H t , v v v v v v v H
H s C c , + , m m S v v v v v H
H s , t s H , , v v v v v v v H
H H + H H H H H H H H H H H H H
H , , , , t , , , , H t s , b H
H , , , , , , , , , + , , , T w
H t p , p t , , t , H t s , t H
H H H + H H w w H H H H H H H H
