H H H H H H H H H H H H H H H H H H
H , t , t , , , t , t , H H H H H H
H t , d c , b , d d , , H H H H H H
H , d T T d , c T T d , H H H H H H
H t , c c , , , c c , , H H H H H H
H , , , , , , , , , , , I , , H H H
H t , c d , , , c d , , I i t H H H
H , c T T c , c T T c , , , , H H H
H t , d c , , , c c , , H H C H H H
H , t , t , , , t , t , H H H H H H
H H H H H H + H H H H H H H H H H H
