H H H w H H w H H w H H H H H H H H
H , t , t , , , t , t , H H H H H H
H t , c c , , , c c , , , ^ H H H H
w , c T T c , c T T c , H H H H H H
H t , c c , , , c c , , H H H H H H
H , , , , , , , , , , , I , , H H H
H t , c c , , , c c , , I , t H H H
w , c T T c , c T T c , I , , H H H
H t , c c , , , c c , , H H + H H H
H , t , t , , , t , t , H H H H H H
H H H w H H + H H w H H H H H H H H
