H H H w H H w H H w H H H H H H H H
H , , , , , , , , , , , H H H H H H
H , , c c , , , c c , , , ^ H H H H
w , c T T c , c T T c , H H H H H H
H , , c c , , , c c , , H H + H H H
H , , , , , , , , , , , I , , H H H
H , , c c , , , c c , , I , , H H H
w , c T T c , c T T c , I , , H H H
H , , c c , , , c c , , H H + H H H
H , , , , , , , , , , , H H H H H H
H H H w H H + H H w H H H H H H H H
