# # # # # # # # # # # # # # # # # # # # # # # # # # # # # # # # # # # # # # # #
# . . . . . . . . . . . . . . . . . . . . . . . . . . . . . . . . . . . . . . #
# . . . . . . . . . . . . . . . . . . . . . . . . . . . . . . . . . . . . . . #
# . . # # # . . . # # # . . # # # . . # # # . . # # # . . # # # . . # # # . . #
# . . # f # . . . # f # . . # f # . . # f # . . # f # . . # f # . . # f # . . #
# . . . p . . . . . p . . . . p . . . . p . . . . p . . . . p . . . . p . . . #
# . . . p . . . . . p . . . . p . . . . p . . . . p . . . . p . . . . p . . . #
# . . . p . . . . . p . . . . p . . . . p . . . . p . . . . p . . . . p . . . #
# . . . p . . . . . p . . . . p . . . . p . . . . p . . . . p . . . . p . . . #
# . . . b . . . . . b . . . . b . . . . b . . . . b . . . . b . . . . b . . . #
# . . . p . . . . . p . . . . p . . . . p . . . . p . . . . p . . . . p . . . #
# . . . p . . . . . p . . . . p . . . . p . . . . p . . . . p . . . . p . . . #
# . . . p . . . . . p . . . . p . . . . p . . . . p . . . . p . . . . p . . . #
# . . . p . . . . . p . . . . p . . . . p . . . . p . . . . p . . . . p . . . #
# . . . p p p p p p p p p p p p p p p p p p p p p p p p p p p p p p p p . . . #
# . . . p p p p p p p p p p p p p p p p p p p p p p p p p p p p p p p p . . . #
# . . . . . . . . . . . . . . . . . p p . . . . . . . . . . . . . . . . . . . #
# . . . . . . . . . . . . . . . . . p p . . . . . . . . . . . . . . . . . . . #
# . . . . . . . . . . . . . . . . . p p . . . . . . . . . . . . . . . . . . . #
# . . . . . . . . . . . . . . - - - - - - - - . . . . . . . . . . . . . . . . #
# . . . . . . . . . . . - - - - - - - - - - - - - - . . . . . . . . . . . . . #
# . . . . . . . . - - - - - - - - - - - - - - - - - - - - . . . . . . . . . . #
# . . . . . . . - - - - - - - - - - - - - - - - - - - - - - . . . . . . . . . #
# . . . . . . . - - - - - - - - - w w w w - - - - - - - - - . . . . . . . . . #
# . . . . . . . - - - - - - - - - w w w w - - - - - - - - - . . . . . . . . . #
# . . . . . . . - - - - - - - - - - w w - - - - - - - - - - . . . . . . . . . #
# . . . . . . . . - - - - - - - - - w w - - - - - - - - - . . . . . . . . . . #
# . . . . . . . . - - - - - - - - - w w - - - - - - - - - . . . . . . . . . . #
# . . . . . . . . . . . - - - - - - w w - - - - - - . . . . . . . . . . . . . #
# . . . . . . . . . . . . . . - - - w w - - - . . . . . . . . . . . . . . . . #
# . . . . . . . . . . . . . . . . . w w . . . . . . . . . . . . . . . . . . . #
# . . . . . . . . . . . . . . . . . w w . . . . . . . . . . . . . . . . . . . #
# . . w w w w . . . . . . . . . . . w w . . . . . . . . . . . . . w w w w . . #
# . . w - - w . . . . . . . . . . . w w . . . . . . . . . . . . . w - - w . . #
# . . w - - w . . . . . . . . . . . w w . . . . . . . . . . . . . w - - w . . #
# . . w w w w . . . . . . . . . . . . . . . . . . . . . . . . . . w w w w . . #
# . . . . . . . . . . . . . . . . . . . . . . . . . . . . . . . . . . . . . . #
# . . . . . . . . . . . . . . . . . . . . . . . . . . . . . . . . . . . . . . #
# . . . . . . . . . . . . . . . . . . . . . . . . . . . . . . . . . . . . . . #
# # # # # # # # # # # # # # # # # # . . # # # # # # # # # # # # # # # # # # # #
