# # # # # # # # # # # # # # #
# # # # # # . . . 9 # # # # #
# # # . . . . # # # # # # # #
# # . . # # # # # # # # # # #
# # . . 5 . . . . . . . # # #
# # . w w w w w w w w w . # #
# # . w , t , , , t , w . # #
# . . w , , , , , , , w . . #
# 5 . w , , w w w , , w . . #
# . . w , , + , + , , w . . #
# . . w , , w , w , , w . . #
# # . w w w w + w w w w . . #
# # # . . . . . . . 5 . . # #
# # # # . . . . . . . . # # #
# # # # # # # . # # # # # # #
