# # # # # . # # # #
# # # . . . . . . #
# # # . p p t . . #
# # # p p p . . # #
# # p p p p p . # #
# . p p p p p . # #
# . . p p p . . # #
# # . t . t . . # #
# # # . . . . . . #
# # # # . # # # # #
